#########
#.      #
#     $.#
### $ ###
#       #
#. $@$ .#
#       #
#########
