#########
#.      #
#     $.#
###   ###
#. $$$ .#
#. $@$ .#
#. $ $ .#
#########
