##########
#      ..#
# $      #  
#    $   #
#  ##@## #
########## 
