##########
# $  $ ..#
# $    ..#  
#    $   #
#  ##@## #
########## 
